2 13 31
###############################
#p     **1*    *   *  * * *   #
#*#*# # # # # # #*# # # # # # #
#      ** * *  *   * ** 2 * * #
# # # # # #*# # #*#*# # # # #*#
#            **  *  *    3    #
# # #*# # # # # #*#*#*#*# # # #
#*  *      *  *1     *        #
# # # # #*# # # #*#*#1 **   * #
#      x*   *2*    *   * 4    #
# #*# # * # # # #*# # * # # * #
# b      1  *   *  *        5 #
###############################


