2 13 31
###############################
#p     **1*    *   *  * * *   #
#*#*# # # # # # #*# # # # # # #
#      ** * *  *   * ** 2 * * #
# # # # # #*# # #*#*# # # # #*#
#            **  *  *         #
# # #*# # # # # #*#*#*#*# # # #
#*  *      *  *1     *        #
# # # # #*# # # #*#*#1 **   * #
#      x*   *2*    *   *      #
# #*# # * # # # #*# # * # # * #
# b      1  *   *  *          #
###############################


