5 13 31
###############################
# 3    ###      ###    ###    #
# 3   #   #    #   #   #4 #   #
# 5   # 1 #    # 2 #   ###    #
# 5   #   #    #   #   #      #
#      ###      ###    #      #
#  ###     ###     ###    ### #
#  #  #    #  #    #  #  #    #
#  #  #  #### #    #  #  #    #
#  #  #    #  #    #  #  #    #
#  ###     ###     ###    ### #
#                             #
###############################


